8
7
########
#O...D #
# .g#1# 
##d###d#
#~ ~M34#
#~p~M P#
####MMMM